#####################
#       #   #       #
# # ### # # ### ### #
# # # #   # #   #   #
### # ##### # #######
#   #     # #   #   #
# ####### # ### # # #
# #     # #   #   # #
# # ### # ### ##### #
#     # #         # #
####### # ####### # #
#       # #   # # # #
# ##### ##### # # # #
# #     #   # # #   #
# # ##### # # # ### #
# #     # #   #   # #
# ##### # ##### ### #
#     # # #         #
# ### ### # #########
#   #     #         #
#####################