#####################################################################################################
#         #       #           #     #           #       #       #   #         #       #       #     #
# ######### ### # ####### ##### # # # ##### ### # ### # ### ### # # # ##### # ### # # # # ### ### # #
#       #   # # #       # #     # # #     # #   #   # #   #   # # #   # #   #   # # # # #   # #   # #
# ##### # ### # ####### # # ##### # ####### # ##### # ### # ### # ##### # ##### ### # ##### # # ### #
# #     #     # #       # #   #   #       # #     # # # # # #   #       # #   # #   #       #   # # #
# # ### ##### # # ####### ### # ######### # ##### ### # # ### # ####### # ### # # ### ########### # #
# # # # #   # # # #         # # #       #   #     #   # # #   #     #   # #   # #   # #   #   # #   #
# # # # # ### # # # # ####### # # # ######### ##### ### # # ######### ### # ### # # ### # # # # # ###
# # #     #   # #   # #     # # # #         #       #   # #         # #   #     # #   # #   # #     #
# # # ##### ### ### ### ### # # ### ##### # ######### ### # ####### # # ##### ####### # ##### #######
# # # #       # #   #   # #   #   #   # # #   #       #   #   #     # #     #         #   # # #     #
# # ### ####### ##### ### ####### ### # # ##### ##### # ##### # ### # ##### ### ######### # # # ### #
# # #   # #   # #     #       #   #     #       #   # # #     # #   # # #   #   #       # # #     # #
# # # ### # # # # ######### # # ######### ####### # # # ####### # ### # # ### ### ### ### # ##### # #
# #   #   # # # #           # #   #     #   #     #   #     #   #   #   #   #   # # #   # # #   # # #
# ##### # # # # ######### ####### # ### ### # ##### ####### # ######### ### ### # # ### # # # # ### #
#   #   # # #     #     # #       # # #   # # #   # #       #             #   # # #   #     # # #   #
### ##### # ####### ### # # # ##### # ### # # # # # # ########### ##### ##### ### # # ####### # # # #
#         # #     #   #   # # #       #   # # # #   #       #   # #   # #   #     # # #       #   # #
# ##### ### # ### ### ##### ### ####### ### # ### ######### # # ### # ### # # ####### # ########### #
# #   # #   #   #         #         #   #   #   #     #     # #     #     # #         # #       #   #
### # ### ### ####################### ### ##### ####### ##### ############# ### ####### # ##### # ###
#   #   # #   #             #   #     # #   # # #       #       #   #     # #   #     #       # #   #
# ##### # # ### ########### # # # ##### ### # # # ########### # # ### ### # ##### ### # ####### #####
#   #     # # #       #   # # #   #       # # # #   #       # # # #   # #   #   # #   # #     #     #
### ####### # ####### # # # # ##### # ##### # # ### ##### # ### # # ### ##### # # # ### # ### ##### #
#   #       #       # # # #   #     #     # # #   #     # # #   # #       #   #   # #   #   #       #
# ### ####### # ##### # ################# # # # ####### # # # ### ####### # ####### ####### # #######
#             # #     #             #   #     # #     # # #   #   #     #   #   #   #       # #     #
E ############# # ####### ### ##### # # ####### # ### # # ##### # # ### ####### # ### ####### # ### #
# #       #   # #       #   # # #     #         # #   #   #   # # # # #         # #     #     #   # #
# # ##### ### # ####### # ### # # ########### ### # ######### # # # # ####### ### # ### # ##### ### #
# #   # #   #         # # #   #     #   #   # #   # #       # # #         #   #   # #   #   #   #   #
S ### # ### ########### # # ### ##### # # # ### ### # # ### # # ########### # # ### # ### ### ### # #
# #   # #   #       #   # #   # #     #   #   # # #   #   # #   #       #   # # # # # #   #   # # # #
# # ### # ### ##### # ### ### # # ########### # # ####### # ##### ##### # ### # # # # ##### ### # ###
# # #         #   # #   #   # # # #       # #   #   # #   #       #   # #   # # #   # #   #     #   #
### # ######### # # ### ### # ### # ##### # ##### # # # ############# # ### # # ##### # # ##### ### #
#   #   #     # # # #   # # #     # # #   #       #   # #           #       # #   #   # #     # #   #
# ##### # ### # # # # ### # ####### # # ######### ### # # ######### ######### ### # ### ### ### # # #
#   #   # # # # # #   # #   #       # # #         # # #   # #     #         #   # #   #   #     # # #
# # # ### # # # # ##### # ### ####### # # ######### # ##### # ### # ####### ### # ### ### ####### # #
# # #   # # # # # #     # #   #   #   # #     #     #       # #   # #       # # #   #     # #     # #
### # ### # # # # # ##### ### # # # # # ##### # ##### ####### # ##### ####### # ### ##### # # ##### #
#   # #   # #   # #           # # # #         #       #     # # #     #   #   # # # #   #   #     # #
# ##### ### ##### ### ########### # ######### ######### ### # # # ##### ### # # # # # # ### ##### # #
# #   #   #     #   #   #       #     #     # #         #   # # #   #       # #   #   #   # #   # # #
# # # ### ##### ### ### # ##### ####### ### # # ### ####### # # ### # ####### ### ####### # # # # # #
#   #             #   # #     #           # # # #   #     #   #     # #       # #     # # #   # # # #
##################### ### ################# ### # ### ### ########### # ##### # ##### # # ##### # ###
#             #     #     #             #   #   # #   # #   #       # #     #     #   # # #   # #   #
# ########### # ### ##### # ########### # ### ### # ### ### ### # ### ##### ##### # ### # ### # ### #
#     #       # # #     # # #     #     # #   # # #       #   # #         # #     # #   #   #   #   #
# ### # ##### # # ##### ### # ##### ##### # ### # ####### ### ##### ####### ####### ### ### ##### ###
# #   # #   #   #           #     #   #   # #     # #     # #     # #     # #       #   # #     #   #
# # ### # # ######### ####### ### ### # ### # ##### # ##### ##### ### ### # # ####### # # ##### ### #
# # #   # #         # #   #   #     #   #   #     # #   #       #     #   #           #   #   #   # #
# # ### # ######### ### # # ### ######### ####### # ### ##### # ####### ### ############# ### ### # #
# #   # #   #     #     # #   # #   #   #   #       #   #   # #   #   #   # #     #             # # #
##### ##### # ### # ##### # ### # # # # # # ######### ### # # ### # # ### ### ### ############### # #
#   #       # #   #     # # #   # #   #   # #         #   # #   #   #   # #   #   #   #   #   #   # #
# # ######### # ######### # # # # ######### # ########### # # ##### # # # # ### ### # # # # # # ### #
# #           # #       # # # # #       #   #           # # # #   # # # # # # #     # # #   #   #   #
# ### ######### # ##### # # # ######### # # ########### # # ### # ### # # # # ####### # ######### # #
# #   #   #   # #   #     # #           # #           #   #     #     # # # #   #     #   #   #   # #
# ### # # # # # # # ####### ############# ########### ################# # # # ### ### ### # # # ### #
#   # # # # # # # #       #       #     # #         #   #     #       # #   #   # # #   # # # #   # #
### ### # # ### ##### ### # ####### ### # ##### ####### ### # # ### ### ####### # # ### # # # ### ###
#   #   # #   #     #   # # #     #   #   #   #             # #   #     #     # # # #   # # #   #   #
# ### ### # # ##### ##### ### ### # # ### # # # ################# ####### # # # # # # ### # ### # # #
#     # # # # #   #     # #   #   # #   # # # # #   #           # #   #   # #   # #     #   # # # # #
# ##### # ### # # ##### # # ##### ##### # # # ### # # ######### # # # # ### ##### ########### # # # #
# #     #   #   #     #   # #   #       # # #     #   #     #   #   # #   #   #   #             # # #
# ##### ### ##### # ####### # # ######### # ############# # # ####### # ##### # # # ############### #
# #   #   #     # #       #   # #         #       #     # # # #     # # #     # # # #               #
# # # # ####### # ##### ### ### # ############### ### # ### # # # ### # # ##### # # ########### #####
#   # #       # #   #   #     # #       #     #   #   #     #   #     # #     # # #           #     #
##### ### ##### # ### ### ##### ######### # ### ### ################### ##### # # ########### ##### #
#         #     # #   #   #   #   #       #     #   #             #         # # # #         #     # #
########### ####### ### ### # ### # ############### # ##### ##### ########### # ### # ########### # #
#   #       #       #   # # #   # # #             # # #     #             #   #   # #   #         # #
# # # ########### # # ### # ### # # ##### ####### # # # ################# # # ### # ### # ######### #
# # # # #       # # # #   #   #   #     #   #     # # #         #           #   #     # # #         #
# # # # # # ### # # # ### ### ######### # # # ##### # ######### ####### ############### # # # # #####
# #   #   # #     # #   #   #       #   # # # #     # #       #       # #               # # # # #   #
# ##### ### ####### ### ### ####### # ##### # ##### # ### ### ####### # # ############# # # # ### # #
#   #   #   #   # #   #         #   #       #   #   #   #   # #       # # #   #   #     # # #     # #
# # ### # ### # # ### ######### # ############# # ##### ##### # ####### # ### # # # ##### ######### #
# #   # #   # # #     #     #   #             # # #           # # #     #   #   # # #   #       #   #
##### # ### # # ##### # ##### ######### ####### # # ########### # # ####### ### # # # # ####### # ###
#     #   # # #     #   #     #       #         #   # #         # #   #   #   # #     # #     # #   #
# ######### # ##### ##### ##### ##### ########### ### # ######### ### # # ### ########### ### # # # #
#   #       #   #   #   # #       # # # #     #       # #       #   # # # # #             # #   # # #
### ### ####### # ### # # ####### # # # # # ### ##### # ##### # # # # # # # ############### ####### #
#   #   #   #   #   # #   #       # # # # #     #   # # #     # # #   # # #       #       #   #   # #
# ### ### # # ##### # ##### ####### # # # ####### # ### # ##### # ##### # ##### # # ### # # # # # # #
#   # #   # #   # #   #     #       # #     #   # #     # #   # # #   # #     # #   #   #   #   #   #
### # # ### ### # ##### ##### ##### # ####### # # ####### # # ### # # # ##### ####### ############# #
#   #     #             #         #           #   #         #       #   #             #             #
#####################################################################################################